82111111178b88b888b8b8
bv4hhhhhs3b8882111117b
bv38b888v388b8v4hhhs38
8v3b8888v3b888v3888v38
8v388b88v61111u38b8v3b
bv388b885hhhhhht888v3b
bv3b88888b888b88b88v38
8v388b8bb8b888888b8v38
8v38888888b21111111u3b
bv3b88b8888v4hhhhhhht8
8v38b888888v3b88b88b8b
bv3b888b8b8v38888b888b
8v38888888bv38b8888b88
8v611111111u3b888b888b
85hhhhhhhhhht88b888b88
b88b888888b888888b88b8

